#separator:tab
#html:false
차	tea; car   茶, 車
사과	apple; apology   沙果
가다	to go
보다	to see, to look at
먹다	to eat
네	yes
아니요	no
커피	coffee
물	water
가방	bag
사무실	office   事務室
학교	school   學校
저	I; that (over there)
뭐	what
책	book   冊
카메라	camera
사전	dictionary; prior, beforehand   辭典, 事前
사람	person, people
우유	milk   牛乳
학생	student   學生
사랑	love
노래	song
일하다	to work
고양이	cat
날씨	weather
오늘	today
좋다	to be good, be nice; to like
하다	to do
오다	to come
사다	to buy
마시다	to drink
자다	to sleep
있다	to exist; to have; to stay
친구	friend; same age person   親舊
돈	money
일어나다	to wake up, get up; to happen
의자	chair   椅子
밥	rice (cooked); meal
엄마	mom
더	more
영화	movie   映畫
읽다	to read
놀다	to hang out, to play
쉬다	to rest, take a rest
고향	hometown   故鄕
웃다	to laugh, smile
요리	cooking, dish   料理
적다	to be few, little;to write down, fill out
끝나다	to end, be over
팔다	to sell
회사원	company employee (in an office)   會社員
어디	where
한국	Korea   韓國
지금	now   只今
도착하다	to arrive   到着
내일	tomorrow   來日
머리	head; hair
여행	trip, travel   旅行
기다리다	to wait
쓰다	to write; to use
나중에	later
어제	yesterday
술	alcoholic drink
공부하다	to study   工夫
청소하다	to clean up, to vacuum   淸掃
노래하다	to sing
운동하다	to work out, to exercise   運動
사랑하다	to love
말	words, language; horse
가게	shop, store
누구	who
전화	telephone   電話
은행	bank   銀行
만들다	to make
어떻게	how
왜	why
얼마	how much (money)
얼마나	how + adjective/adverb
빨리	quickly
찾다	to look for; to find; to withdraw (money)
말하다	to speak
내다	to pay; to hand in;  to produce
도서관	library   圖書館
옷	clothes
자주	often
크다	to be big; to grow
서울	Seoul
여기	here
아침	morning, breakfast
선물	present, gift   膳物
남자	man, male   男子
한국어	Korean (language)   韓國語
생각하다	to think
캐나다	Canada
아내	wife
눈	eye; snow
음악	music   音樂
저녁	evening; dinner
의사	doctor, physician; intention, idea   醫師, 意思
미국	USA   美國
일본	Japan   日本
아이스크림	ice cream
영어	English (language)   英語
만나다	to meet
거기	there
금요일	Friday   金曜日
혼자	alone
정말	really, seriously   正-
입다	to put on, wear
아기	baby
여자	woman, female   女子
생일	birthday   生日
치마	skirt
비	rain
방	a room   房
텔레비전	TV
번	time (first, second...)   番
아이	child
여러분	everyone, ladies and gentlemen
음식	food   飮食
그리고	and
빵	bread
그래서	therefore
프랑스	France
많이	a lot, many, plenty
같이	together
춤추다	to dance
선생님	teacher   先生-
컴퓨터	computer
피곤하다	to be tired   疲困
새	new; bird
월요일	Monday   月曜日
화요일	Tuesday   火曜日
좋아하다	to like
오렌지	orange
딸기	strawberry
매일	every day   每日
그런데	by the way, but then
포도	grape   葡萄
배	pear; stomach; boat
수박	watermelon
그렇지만	but, however
늦게	late
밤	night; chestnut
시험	exam, test   試驗
받다	to receive, accept; to take
잔	cup, glass   盞
모르다	to not know
나오다	to come out
초콜릿	chocolate
고기	meat
수요일	Wednesday   水曜日
목요일	Thursday   木曜日
그럼	then, if so; that's right
아주	very much
식당	restaurant, cafeteria, diner   食堂
병원	hospital   病院
닫다	to close
수영하다	to swim   水泳
배우다	to learn
분	minute; person (hon.)   分
보통	usually, normally   普通
수업	class, instruction   受業·授業
지하철	subway   地下鐵
중요하다	to be important   重要
까만색	black
개	dog; thing (count.)
연필	pencil   鉛筆
몇	how many
다	all
시장	market; mayor   市場, 市長
토요일	Saturday   土曜日
일요일	Sunday   日曜日
듣다	to listen, to hear
잠	sleep, nap
화장실	toilet, bathroom   化粧室
공항	airport   空港
이름	name
여동생	younger sister   女--
취미	hobby   趣味
살다	to live
대학교	college   大學校
가르치다	to teach
태어나다	to be born
바쁘다	to be busy
가족	family   家族
직업	job, occupation   職業
주다	to give
이야기하다	to talk
앉다	to sit, sit down
싫어하다	to dislike
버스	bus
주스	juice
아직	yet, still
점심	lunch; afternoon   點心
올해	this year
극장	movie theater; theater   劇場
신문	newspaper   新聞
잡다	to catch, grab, take
준비하다	to prepare   準備
일찍	early
바지	pants
조금	a little
비싸다	to be expensive
빠르다	to be quick, fast
멀다	to be far
나쁘다	to be bad
덥다	to be hot (regarding the weather)
운전하다	to drive   運轉
잘못하다	to make a mistake
글	writing, a piece of writing, text
빌리다	to borrow
숙제	homework   宿題
자전거	bicycle   自轉車
찍다	to take a picture; to mark, stamp, dip into, chop
사진	picture, photo   寫眞
편지	letter, note   便紙·片紙
계획	plan, project   計劃
알다	to know, understand
빨간색	red
가깝다	to be close
주말	weekend   週末
백화점	department store   百貨店
서점	bookstore   書店
회사	company, corporation   會社
오전	before noon   午前
힘들다	to be difficult, tiring, painful
쉽다	to be easy
싸다	to be inexpensive, cheap; to wrap up, pack
아름답다	to be beautiful
춥다	to be cold (regarding the weather)
맵다	to be spicy, hot; to be intense
귀엽다	to be cute
아프다	to be sick; to hurt, ache
예쁘다	to be pretty, charming
봄	spring
맑다	to be clear, clean
오후	after noon   午後
다르다	to be different
부르다	to call, to call out
먼저	first, ahead
같다	to be the same (as); to look like, seem like
어렵다	to be difficult, hard
독일	Germany   獨逸
모두	all together, everyone
층	floor (count.)   層
싫다	to not like, to not want to do
슬프다	to be sad
제일	the most   第一
길다	to be long
작다	to be small
맞다	to be correct; to be hit, struck
맛	taste, flavor
나무	tree; wood
졸업하다	to graduate   卒業
월	month   月
잠시	a short while   暫時
그렇다	to be so (like that)
문제	problem, question   問題
고르다	to choose, pick; to be regular, even
조심하다	to be careful, watch out   操心
모레	the day after tomorrow
부엌	kitchen
공원	park   公園
불	fire; light
돕다	to help
침대	bed   寢臺
약속	appointment; promise   約束
못하다	to be unable to do
속	inside
가지다	to posess (have)
왼쪽	left side
길	street, road
유명하다	to be famous   有名
멋있다	to be attractive, stylish, cool
택시	taxi
곳	place
여러	many, several
글쎄	well, let me see
할머니	grandmother
설명하다	to explain   說明
말다	to not do; to put into soup; to roll
걱정하다	to worry
보내다	to send; to pass (spend) time
위	above, top, senior; stomach   胃
무겁다	to be heavy
책상	desk   冊床
앞	the front
아래	under
냉장고	refrigerator   冷藏庫
축하하다	to congratulate   祝賀
뒤	behind
구두	dress shoes
질문	question   質問
시작하다	to start, begin   始作
아들	son
날짜	date (in a calendar)
옆	beside, next to
안	inside, within; not; proposal   案
소금	salt
별로	not particularly   別-
키	height
너무	too (much)
달	month, moon
인사하다	to greet; to say goodbye   人事
흐리다	to be cloudy
요즘	these days
교실	classroom   敎室
제	my
다시	again
편의점	convenience store   便宜店
자동차	car   自動車
되다	to become, get, turn into  한국어를 잘하게 되고 싶어요.  = I want to become good at Korean
동안	during, interval
아버지	father
외국	foreign country   外國
약	drug, medicine; approximately   藥, 約
외국어	foreign language   外國語
재미있다	to be fun, interesting
산책하다	to take a walk   散策
계속	continuously   繼續
어머니	mother
다음	the next, the following
역	train station; part in a play   驛, 役
나가다	to go out
우리	we (informal)
년	year   年
가장	the most (more formal than 제일)
바로	right there; directly
딸	daughter
이렇게	like this, in this way
열심히	diligently, passionately   熱心
대답	answer   對答
전	before, prior to   前
들어오다	to come in, enter
얼굴	face
형	a man's older brother; type, style; punishment   兄, 型, 刑
천천히	slowly
마음	mind, heart, nature
조용하다	to be quiet
반갑다	to be glad, happy, pleased
생선	fish (for eating)   生鮮
건강	health   健康
부모님	parents   父母-
휴가	vacation   休暇
밖	the outside
다니다	to go (frequently), to attend, work for
항상	always   恒常
계속하다	to continue   繼續
울다	to cry
꽃	flower
볼펜	ballpoint pen
공책	notebook  공책에 사진이 있어요 = There is a picture in  the notebook   空冊
주인	owner, employer   主人
모자	hat, cap; mother and son   帽子, 母子
겨울	winter
물건	thing, object, article   物件
많다	to be many, to be plenty
값	price, cost
미안하다	to be sorry (less formal)   未安
라면	ramen
바꾸다	to change, switch, alter
신발	shoes, footwear
열쇠	key
걸리다	to take time; to hang;  to be caught   감기에 걸렸어요 = I caught a cold
넓다	to be wide, spacious
방학	school holiday   放學
시원하다	to be cool, refreshing
가수	singer   歌手
감기	cold (the illness)   感氣
씻다	to wash
손	hand
연락하다	to contact, keep in touch   連絡
대화	conversation   對話
치다	to play a game; to hit, attack
타다	to ride, get in; to burn, be tanned
깨끗하다	to be clean
연습하다	to practice, train   練習
병	bottle; sickness, disease   甁
늦다	to be late
문	door   門
반	half; group, class   半, 班
세수하다	to wash one's face   洗手
걷다	to walk
복잡하다	to be crowded; to be complicated   複雜
필요하다	to need   必要
인터넷	internet
열다	to open
켜다	to turn on, switch on
묻다	to ask; to stick to, be stained; to bury
바람	wind, breeze; wish, desire
놓다	to lay, put, place; to let go
식사	meal   食事
회의	meeting, conference   會議
약국	pharmacy   藥局
힘	power, strength, force, capability
지나다	to pass, go by  웨이터가 지나갔어요 = The waiter passed by
배우	actor   俳優
구경하다	to go sightseeing, look around; to see, watch (a show, movie, play, sports game etc.)
할아버지	grandfather
누나	older sister (of a male)
계시다	to exist (hon.)
손님	guest; customer
비행기	airplane   飛行機
하얗다	to be white
달다	to be sweet; to put up, attach; to weigh, measure
여름	summer
참	very, really
야구	baseball   野球
어떤	some, certain; what kind of
내리다	to come down, put down; to get out of; to take off
장소	place, location   場所
따뜻하다	to be warm, kind
날	day, date; edge
산	mountain   山
초대하다	to invite   招待
바다	sea, ocean
과일	fruit
번호	number   番號
나라	country, nation
이따가	a little later
어느	which
샤워하다	to take a shower
기분	mood, feeling   氣分
며칠	several days; day of the month
작년	last year   昨年
실례하다	to be excused   失禮
잠깐	for a little while
좀	a little; kindly; certainly
높다	to be high; to be noble
짜다	to be salty; to make, build, organize; to squeeze
낮다	to be low
짧다	to be short
바나나	banana
언니	older sister (of a female)
오빠	older brother (of a female)
출발하다	to depart, leave   出發
고맙다	to be thankful, grateful
처음	first, at first, first time
문화	culture   文化
창문	window   窓門
오른쪽	right side
잘	well
함께	together, in company with
남편	husband   男便
시간	time; hours   時間
몸	body, figure
밑	the bottom, below
이번	this time   -番
생활	life, living, livelihood   生活
사이	relationship; distance apart
그때	then, at that time
서다	to stand; to stop
넣다	to put in, insert
얘기	story; talk, conversation
생기다	to occur, happen; to look; to form
올라가다	to go up
사용하다	to use, make use of   使用
그래	yes, okay
입	mouth
그림	drawing, painting  이건 아주 유명한 그림이에요 = This is a very famous painting.
아빠	dad
가을	autumn
부탁하다	to request, ask a favor   付託
죄송하다	to be sorry, feel guilty   罪悚
꼭	certainly, for sure
그리다	to draw a picture
하지만	but, though
잘하다	to do well, be skillful
그렇게	so, like that
발	foot
살	years of age (count.); flesh, muscle
이유	reason, cause   理由
지내다	to spend time; to pursue; to associate with
예	example; yes   例
아저씨	mister
건물	building   建物
걸다	to hang, suspend; to speak to, call
다리	leg; bridge
주소	address, residence   住所
파랗다	to be blue
친절하다	to be kind, considerate   親切
돌아오다	to come back, return
에어컨	air conditioner
전화하다	to make a phone call   電話
안녕히	peacefully; safely   安寧
기차	train   汽車
말씀하시다	to speak, talk (hon.)
괜찮다	to be okay
귀	ear
남동생	younger brother   男--
물어보다	to ask, question
돌아가다	to go back, return; to work, operate
아파트	apartment building
게임	game
내려오다	to come down, get off
팔	arm
단어	word, vocabulary   單語
영화관	movie theater   映畫館
들다	to get in, be in; to carry, hold; to lift, raise
그릇	bowl, container
드리다	to give, offer (hon.)
근처	nearby   近處
낮	daytime
가볍다	to be light (as opposed to heavy)
목	neck; throat
코	nose
배고프다	to be hungry
교통	traffic   交通
불다	to blow
축구	football (soccer)   蹴球
차갑다	to be cold (regarding objects)
소개하다	to introduce, recommend   紹介
박물관	museum   博物館
어서	please, kindly; quickly
또	again, repeatedly; also, too
외국인	foreigner   外國人
지난달	last month
시계	clock, watch   時計
화	anger; disaster, misfortune   火, 禍
아주머니	middle aged woman; aunt
못	not; nail
다녀오다	to go and get back, be back
이쪽	this side, our side
내년	next year   來年
안녕하다	to be well, be in good health   安寧
계절	season   季節
지갑	wallet; purse   紙匣
표	ticket; table, diagram; mark, sign   票, 表
드라마	TV series
없다	to not exist; to not have
파티	party (social gathering)
카드	card
도와주다	to help out, assist
호텔	hotel
운동장	field, (school) stadium; playground   運動場
한복	Korean dress (traditional)   韓服
때	time; when; occasion; dirt
안경	glasses, eyeglasses   眼鏡
이	tooth; this
신다	to put on, wear (footwear)
불고기	marinated beef
피아노	piano
메뉴	menu
집	house, home, family
농구	basketball   籠球
콜라	coke
정류장	stop, station (bus etc.)   停留場
가격	price   價格
특히	especially, particularly   特-
휴지	toilet paper, tissue; pause   休紙, 休止
태권도	Taekwondo   跆拳道
전공하다	to major in, specialize in   專攻
사귀다	to date, go out; to make friends with, keep company with
끄다	to put out, turn off
언제	when
너	you (informal)
알리다	to inform, let know, notify
일월	January   一月
수영장	swimming pool   水泳場
아르바이트	part-time job
동생	younger sibling, younger friend
퇴근하다	to go home from work   退勤
피우다	to smoke;to bloom, blossom; to make a fire
갈아타다	to change vehicles, transfer
특별하다	to be special, extraordinary   特別
무슨	which/what (+ noun)
주무시다	to sleep (hon.)
기간	period, term   期間
기쁘다	to be glad, happy, pleased
전화번호	phone number   電話番號
등산	hiking, mountain climbing   登山
쇼핑	shopping
일	work, matter; day   日
갈비	barbecued spare ribs
음료수	beverage, drink   飮料水
제주도	Jeju Island   濟州島
케이크	cake
잡수시다	to eat (hon.)
나	I (informal)
거실	living room   居室
감사하다	to be thankful, thank, appreciate   感謝
무엇	what, which, something (the unshortened form of 뭐)
그	that (before nouns)
맛있다	to be delicious, tasty
아니다	to not be
시	time, hour; o'clock; poem   時, 詩
명	counter for people   名
권	counter for books   卷
영국	United Kingdom   英國
김치	kimchi (traditional Korean dish made of seasoned vegetables and other ingredients)
컵	cup
비빔밥	boiled rice with assorted mixtures
냉면	cold noodles   冷麵
싱겁다	to be bland, not salty enough
어떻다	to be the manner in which something is done
김밥	Korean dried seaweed rice rolls
한가하다	to be free, have leisure, have time to spare   閑暇
남산	Namsan, Mt. Nam (in Seoul)   南山
그러니까	therefore, consequently
하숙집	boarding house   下宿-
들어가다	to enter, go in
대학	university   大學
생신	birthday (hon.)   生辰
부산	Busan   釜山
떡볶이	rice-stick with vegetables
시다	to be sour
노란색	yellow
하얀색	white
재미없다	to be boring, dull
저기	over there
저쪽	that side, over there
그쪽	that, that way; you
요일	day of the week   曜日
생각	thought, idea
잡채	noodles with sauteed vegetables   雜菜
남대문	the South Gate   南大門
삼계탕	chicken soup with ginseng   蔘鷄湯
이거	this thing
오월	May   五月
유월	June   六月
이월	February   二月
삼월	March   三月
씨	Mr., Ms.; seed, kernel   氏
사월	April   四月
칠월	July   七月
한국말	Korean language   韓國-
팔월	August   八月
구월	September   九月
시월	October   十月
십일월	November   十一月
십이월	December   十二月
지난주	last week   --週
건강하다	to be healthy   健康
대학생	college student   大學生
안내하다	to guide, lead the way   案內
티셔츠	T-shirt
중국	China   中國
지하철역	subway station   地下鐵驛
김치찌개	kimchi stew
파란색	blue
일주일	one week   一週日
그런	such, that kind of
이곳	this place, here
맛없다	to be tasteless, unsavory
갈비탕	beef rib soup
영화배우	movie actor   映畫俳優
